15 14
###############
#             #
#             #
#             #
#             #
#     ##      #
#     ##      #
#     2##     #
#      ##     #
#      1      #
#             #
#             #
#             #
###############
